#---------
#------###
#-----#---
#-----#---
------#---
---#---#--
------#---
----------
#----####-
#---------